############
#          #
#   O      #
#     O    #######
#                #
#   X    X       #
#                #
#      P   #######
############