############
#          #
#   P   ####
#          #
#######    #
#    ##    #
#    ##    #
#          #
#          #
#       #  #
############